0000000000000000000000000000000
000GGGGGGGGGGGGGGGQQQ0000000000
000GGXGGGGGGCGGGGGGGQ0000000000
000GGGGGGGGGGGGGGGGGQ0000000000
0000000000000000QGGQQ0000000000
0000000000000000QGGGG0000000000
0000000000000000QGGG00000000000
0000G000000000000GGG00000000000
0000GG00000000000GGG00000000000
0000GGGGG0000000000000000000000
0000GGGGGGG000000GGG00000000000
0000GGCCGGG0000000GGGGGGGG00000
0000GGCGGGG00000000000000G00000
0000GGGGGGGGGGGGGGGGGGGGGG00000
0000000000000000000000000000000
0000000000000000000000000000000